wwwwwwwwwwwwwwwwwwwwwwwww
w  v                    w
wr v                    w
w  v    e         c     w
wfffgfmfffggffmffgffmfflw
w                      lw
w         c c          lw
wlfffffgffsfmmgffffggfffw
wl             c        w
wl    e                 w
wfffgfffmffsffgfffggffflw
w  c                   lw
w     e     c          lw
wlfsffmffgfffgfffggfmfffw
wl                      w
wl      e    c          w
wffmfgffgffmffggffl     w
w                 l     w
wp                l  a  w
wfggfffffgggfffgffgfffffw