wwwwwwwwwwwwwwwwwwwwwwww
w                      w
w                      w
w                      w
w                      w
w                      w
w                      w
w                      w
w                      w
w                      w
w                      w
w                      w
w                      w
w                      w
w                      w
w                      w
w                l     w
w                l     w
wp               l     w
wwwwwwwwwwwwwwwwwwwwwwww